
R 1280 720

NO ./textures/bricks.xpm
SO ./textures/bricks.xpm
WE ./textures/bricks.xpm
EA ./textures/bricks.xpm

S ./textures/barrel.xpm
F ./textures/ground.xpm
C ./textures/skybox.xpm

111111111111111111111111111111111
111113000000000000111111000300211
111111200001111010111111011100111
111111000001111010111200011001111
111221111011111310000000000000111
110000000011111110111111111110011
110111111011111110000000011110311
100111111011111110111111011111111
130111100011112000021111000011111
110000001111110000001111002011111
1111100011111100N0001111200011111
111112000000000000031111111003111
111111111111111111111111111111111