
R 1280 720

NO ./textures/mossy.xpm
SO ./textures/greystone.xpm
WE ./textures/bluestone.xpm
EA ./textures/purplestone.xpm

S ./textures/barrel.xpm
F 34,139,34
C 135,206,235

111111111111
120000000021
100011110001
1001    1001
1001    1001
100011110001
120000N00021
111111111111